{
    "A": 119860,
    "B": 119861,
    "C": 119862,
    "D": 119863,
    "E": 119864,
    "F": 119865,
    "G": 119866,
    "H": 119867,
    "I": 119868,
    "J": 119869,
    "K": 119870,
    "L": 119871,
    "M": 119872,
    "N": 119873,
    "O": 119874,
    "P": 119875,
    "Q": 119876,
    "R": 119877,
    "S": 119878,
    "T": 119879,
    "U": 119880,
    "V": 119881,
    "W": 119882,
    "X": 119883,
    "Y": 119884,
    "Z": 119885
}
