{
    "A": 119860,
    "B": 119861,
    "C": 119862,
    "D": 119863,
    "E": 119864,
    "F": 119865,
    "G": 119866,
    "H": 119867,
    "I": 119868,
    "J": 119869,
    "K": 119870,
    "L": 119871,
    "M": 119872,
    "N": 119873,
    "O": 119874,
    "P": 119875,
    "Q": 119876,
    "R": 119877,
    "S": 119878,
    "T": 119879,
    "U": 119880,
    "V": 119881,
    "W": 119882,
    "X": 119883,
    "Y": 119884,
    "Z": 119885,
    "a": 119886,
    "b": 119887,
    "c": 119888,
    "d": 119889,
    "e": 119890,
    "f": 119891,
    "g": 119892,
    "h": 8462,
    "i": 119894,
    "j": 119895,
    "k": 119896,
    "l": 119897,
    "m": 119898,
    "n": 119899,
    "o": 119900,
    "p": 119901,
    "q": 119902,
    "r": 119903,
    "s": 119904,
    "t": 119905,
    "u": 119906,
    "v": 119907,
    "w": 119908,
    "x": 119909,
    "y": 119910,
    "z": 119911
}
